15
25
P P P P P P P P P P P P P P P P P P P P P P P P P 
P P P P P P P P P P P P P P P P P P P P P P P P P
P P P P P P P B P P P P P P P P P P P P P A A P P 
L L A A A A A L L A A A A A P P P P P P P P P A P 
P P P P P P P P P P P P P P P P P P P P P P H P A 
P P P P P P P P P P P P P P P P P P P P P P P P P 
P P P P P P P P P P P P H P P P P P P P P P P P P 
P P P H P P P P P P P P P P P P P P P H P P P P P 
P B P P P P P P P P P P P P P P A P P B P P P P P 
P P P P P P P P B P P P P P P P P P P P P P P P P 
L A A A A A L L L A A A A A L L P P P P P P P P P 
P P P P P P P P P P P P P P P P P P P P P P P P P 
L L L L A A A L L L P P P P P P P P P P P P P P P 
P P P P P P P P P P P L L L P P L L L L L L L L L
P P P P P P P P P P P L F L P P P P P P P P P P P 
