14
13
P P P P P P P P P P P P P 
P L P L P L P L P L P H P
P L P L P L P L P L P L P
P L P L P L A L P L P L P
P L P L P P P P P L P L P
P P P P P L P L P P P P P
A P L L P P H P P L L P A
P P P P P L P L P P P P P
P L P L P L L L P L P L P
P L P L P L P L P L P L P
P L P L P L P L P L P L P
H L P L P L P L P L P L P
P L P L P L L L P L P L P
P P P P P L F L P P P P P